- Getting started
Getting started - Using TikTok
Using TikTok - Account and privacy settingsAccount informationScreen timeChanging language preferencesAccount regionAccount privacy settingsChoosing between a private or public accountSuggested accountsTikTok Global Privacy CenterLink your email on Android devicesTeen privacy and safety settingsLocation information on TikTokActivity Status on TikTokCommentsDuet privacy settingsStitch privacy settingsRefresh your For You feedRemove original soundsManage video downloadsVideo privacyDark modeProfile view historyTikTok post view historyVideosDuet and StitchManage direct messagesPost privacy settingsManage video downloadsAds and dataHow your ads are personalizedMute advertisersControl your off-TikTok dataAbout this adCommercial Content LibraryRequesting your dataHow your email and phone number are used on TikTokTikTok Mobile Application Identifier appChange your personalized ads settingsDeleting an accountDelete your accountDeactivate your account
Account and privacy settings - Account informationScreen timeChanging language preferencesAccount region
Account information - Screen time
Screen time - Changing language preferences
Changing language preferences - Account region
Account region - Account privacy settingsChoosing between a private or public accountSuggested accountsTikTok Global Privacy CenterLink your email on Android devicesTeen privacy and safety settingsLocation information on TikTokActivity Status on TikTokCommentsDuet privacy settingsStitch privacy settingsRefresh your For You feedRemove original soundsManage video downloadsVideo privacyDark modeProfile view historyTikTok post view historyVideosDuet and StitchManage direct messagesPost privacy settingsManage video downloads
Account privacy settings - Choosing between a private or public account
Choosing between a private or public account - Suggested accounts
Suggested accounts - TikTok Global Privacy Center
TikTok Global Privacy Center - Link your email on Android devices
Link your email on Android devices - Teen privacy and safety settings
Teen privacy and safety settings - Location information on TikTok
Location information on TikTok - Activity Status on TikTok
Activity Status on TikTok - Comments
Comments - Duet privacy settings
Duet privacy settings - Stitch privacy settings
Stitch privacy settings - Refresh your For You feed
Refresh your For You feed - Remove original sounds
Remove original sounds - Manage video downloads
Manage video downloads - Video privacy
Video privacy - Dark mode
Dark mode - Profile view history
Profile view history - TikTok post view history
TikTok post view history - Videos
Videos - Duet and Stitch
Duet and Stitch - Manage direct messages
Manage direct messages - Post privacy settings
Post privacy settings - Manage video downloads
Manage video downloads - Ads and dataHow your ads are personalizedMute advertisersControl your off-TikTok dataAbout this adCommercial Content LibraryRequesting your dataHow your email and phone number are used on TikTokTikTok Mobile Application Identifier appChange your personalized ads settings
Ads and data - How your ads are personalized
How your ads are personalized - Mute advertisers
Mute advertisers - Control your off-TikTok data
Control your off-TikTok data - About this ad
About this ad - Commercial Content Library
Commercial Content Library - Requesting your data
Requesting your data - How your email and phone number are used on TikTok
How your email and phone number are used on TikTok - TikTok Mobile Application Identifier app
TikTok Mobile Application Identifier app - Change your personalized ads settings
Change your personalized ads settings - Deleting an accountDelete your accountDeactivate your account
Deleting an account - Delete your account
Delete your account - Deactivate your account
Deactivate your account - Safety
Safety - Log in and troubleshootingLog inSave your login informationForgot my passwordReset passwordEmail and phone numberMy account has been hackedMy account logged out automaticallyLog in with a passkeyBrowse as guestStill need help?TroubleshootingFirst stepsIssues with TikTok LIVEReport a problemA sound I added to TikTok was removedA sound was removed from my videoWhy am I seeing a "...too fast" error message?
Log in and troubleshooting - Log inSave your login informationForgot my passwordReset passwordEmail and phone numberMy account has been hackedMy account logged out automaticallyLog in with a passkeyBrowse as guestStill need help?
Log in - Save your login information
Save your login information - Forgot my password
Forgot my password - Reset password
Reset password - Email and phone number
Email and phone number - My account has been hacked
My account has been hacked - My account logged out automatically
My account logged out automatically - Log in with a passkey
Log in with a passkey - Browse as guest
Browse as guest - Still need help?
Still need help? - TroubleshootingFirst stepsIssues with TikTok LIVEReport a problemA sound I added to TikTok was removedA sound was removed from my videoWhy am I seeing a "...too fast" error message?
Troubleshooting - First steps
First steps - Issues with TikTok LIVE
Issues with TikTok LIVE - Report a problem
Report a problem - A sound I added to TikTok was removed
A sound I added to TikTok was removed - A sound was removed from my video
A sound was removed from my video - Why am I seeing a "...too fast" error message?
Why am I seeing a "...too fast" error message? - TikTok LIVE, Gifts, and wallet
TikTok LIVE, Gifts, and wallet - Monetize on TikTok
Monetize on TikTok # Screen time # Changing language preferences # Account region # Helpful links
Creating an account Setting up your profile #### Company ##### About TikTok ##### Newsroom ##### Contact ##### Careers #### Programs ##### TikTok for Good ##### TikTok for Developers ##### Effect House ##### Advertise on TikTok ##### TikTok Rewards ##### TikTok Browse ##### TikTok Embeds #### Resources ##### Help Center ##### Safety Center ##### Creator Academy ##### Community Guidelines ##### Transparency ##### Accessibility #### Legal ##### Terms of Use ##### Privacy Policy ##### Copyright Policy ##### Law Enforcement ##### TikTok Cookies Policy
English 

----------
Дата извлечения: 2025-05-16 22:03:20